NO 			textures/north.xpm
SO textures/south.xpm
WE 		textures/west.xpm
EA textures/east.xpm

F 82, 70, 50
C 138, 209, 227

11111111111111111111111111111111111111111111111111111
10N00000000000000000000000000000000000000000000000001
10001111111111111111111111111111111111111111111110001
1000111                                        110001
1000111    11111111111111111111111111111111    110001
1000111    10000000000000000000000000000001    110001
1000111    10000111100111111111110011110001    110001
1000111    100001  1001         1001  10001    110001
1000111    100001  1001         1001  10001    110001
1000111    100001  1001         1001  10001    110001
1000111    10000111100111111111110011110001    110001
1000111    10000000000000000000000000000001    110001
1000111    11111111111110001111111111111111    110001
1000111                10001                   110001
10001111111111111111111100011111111111111111111110001
10000000000000000000000000000000000000000000000000001
11111111111111111111111111111111111111111111111111111
